{
  "values": [
    [
      0,1,2,3,6,8,12,14
    ],
    [
      0,1,2,3,6,8,12,14
    ],
    [
      0,1,2,3,6,8,12,14
    ],
    [
      0,1,2,3,6,8,12,14
    ],
    [
      4,5,16,18,24,25,26,36
    ],
    [
      4,5,16,18,24,25,26,36
    ],
    [
      0,1,2,3,6,8,12,14
    ],
    [
      7,9,10,11,13,15,20,21
    ],
    [
      0,1,2,3,6,8,12,14
    ],
    [
      7,9,10,11,13,15,20,21
    ],
    [
      7,9,10,11,13,15,20,21
    ],
    [
      7,9,10,11,13,15,20,21
    ],
    [
      0,1,2,3,6,8,12,14
    ],
    [
      7,9,10,11,13,15,20,21
    ],
    [
      0,1,2,3,6,8,12,14
    ],
    [
      7,9,10,11,13,15,20,21
    ],
    [
      4,5,16,18,24,25,26,36
    ],
    [
      17,19,22,23,27,38,47,58
    ],
    [
      4,5,16,18,24,25,26,36
    ],
    [
      17,19,22,23,27,38,47,58
    ],
    [
      7,9,10,11,13,15,20,21
    ],
    [
      7,9,10,11,13,15,20,21
    ],
    [
      17,19,22,23,27,38,47,58
    ],
    [
      17,19,22,23,27,38,47,58
    ],
    [
      4,5,16,18,24,25,26,36
    ],
    [
      4,5,16,18,24,25,26,36
    ],
    [
      4,5,16,18,24,25,26,36
    ],
    [
      17,19,22,23,27,38,47,58
    ],
    [
      28,37,40,45
    ],
    [
      29,30,31,32,33,34,35,39,41,42,43,44,46,48,49,50,51,52,53,54,55,56,57,59,60,61,62,63,64,65,66,67,68,69,70,71,72,73,74,75,76,77,78,79,80,81,82,83,84
    ],
    [
      29,30,31,32,33,34,35,39,41,42,43,44,46,48,49,50,51,52,53,54,55,56,57,59,60,61,62,63,64,65,66,67,68,69,70,71,72,73,74,75,76,77,78,79,80,81,82,83,84
    ],
    [
      29,30,31,32,33,34,35,39,41,42,43,44,46,48,49,50,51,52,53,54,55,56,57,59,60,61,62,63,64,65,66,67,68,69,70,71,72,73,74,75,76,77,78,79,80,81,82,83,84
    ],
    [
      29,30,31,32,33,34,35,39,41,42,43,44,46,48,49,50,51,52,53,54,55,56,57,59,60,61,62,63,64,65,66,67,68,69,70,71,72,73,74,75,76,77,78,79,80,81,82,83,84
    ],
    [
      29,30,31,32,33,34,35,39,41,42,43,44,46,48,49,50,51,52,53,54,55,56,57,59,60,61,62,63,64,65,66,67,68,69,70,71,72,73,74,75,76,77,78,79,80,81,82,83,84
    ],
    [
      29,30,31,32,33,34,35,39,41,42,43,44,46,48,49,50,51,52,53,54,55,56,57,59,60,61,62,63,64,65,66,67,68,69,70,71,72,73,74,75,76,77,78,79,80,81,82,83,84
    ],
    [
      29,30,31,32,33,34,35,39,41,42,43,44,46,48,49,50,51,52,53,54,55,56,57,59,60,61,62,63,64,65,66,67,68,69,70,71,72,73,74,75,76,77,78,79,80,81,82,83,84
    ],
    [
      4,5,16,18,24,25,26,36
    ],
    [
      28,37,40,45
    ],
    [
      17,19,22,23,27,38,47,58
    ],
    [
      29,30,31,32,33,34,35,39,41,42,43,44,46,48,49,50,51,52,53,54,55,56,57,59,60,61,62,63,64,65,66,67,68,69,70,71,72,73,74,75,76,77,78,79,80,81,82,83,84
    ],
    [
      28,37,40,45
    ],
    [
      29,30,31,32,33,34,35,39,41,42,43,44,46,48,49,50,51,52,53,54,55,56,57,59,60,61,62,63,64,65,66,67,68,69,70,71,72,73,74,75,76,77,78,79,80,81,82,83,84
    ],
    [
      29,30,31,32,33,34,35,39,41,42,43,44,46,48,49,50,51,52,53,54,55,56,57,59,60,61,62,63,64,65,66,67,68,69,70,71,72,73,74,75,76,77,78,79,80,81,82,83,84
    ],
    [
      29,30,31,32,33,34,35,39,41,42,43,44,46,48,49,50,51,52,53,54,55,56,57,59,60,61,62,63,64,65,66,67,68,69,70,71,72,73,74,75,76,77,78,79,80,81,82,83,84
    ],
    [
      29,30,31,32,33,34,35,39,41,42,43,44,46,48,49,50,51,52,53,54,55,56,57,59,60,61,62,63,64,65,66,67,68,69,70,71,72,73,74,75,76,77,78,79,80,81,82,83,84
    ],
    [
      28,37,40,45
    ],
    [
      29,30,31,32,33,34,35,39,41,42,43,44,46,48,49,50,51,52,53,54,55,56,57,59,60,61,62,63,64,65,66,67,68,69,70,71,72,73,74,75,76,77,78,79,80,81,82,83,84
    ],
    [
      17,19,22,23,27,38,47,58
    ],
    [
      29,30,31,32,33,34,35,39,41,42,43,44,46,48,49,50,51,52,53,54,55,56,57,59,60,61,62,63,64,65,66,67,68,69,70,71,72,73,74,75,76,77,78,79,80,81,82,83,84
    ],
    [
      29,30,31,32,33,34,35,39,41,42,43,44,46,48,49,50,51,52,53,54,55,56,57,59,60,61,62,63,64,65,66,67,68,69,70,71,72,73,74,75,76,77,78,79,80,81,82,83,84
    ],
    [
      29,30,31,32,33,34,35,39,41,42,43,44,46,48,49,50,51,52,53,54,55,56,57,59,60,61,62,63,64,65,66,67,68,69,70,71,72,73,74,75,76,77,78,79,80,81,82,83,84
    ],
    [
      29,30,31,32,33,34,35,39,41,42,43,44,46,48,49,50,51,52,53,54,55,56,57,59,60,61,62,63,64,65,66,67,68,69,70,71,72,73,74,75,76,77,78,79,80,81,82,83,84
    ],
    [
      29,30,31,32,33,34,35,39,41,42,43,44,46,48,49,50,51,52,53,54,55,56,57,59,60,61,62,63,64,65,66,67,68,69,70,71,72,73,74,75,76,77,78,79,80,81,82,83,84
    ],
    [
      29,30,31,32,33,34,35,39,41,42,43,44,46,48,49,50,51,52,53,54,55,56,57,59,60,61,62,63,64,65,66,67,68,69,70,71,72,73,74,75,76,77,78,79,80,81,82,83,84
    ],
    [
      29,30,31,32,33,34,35,39,41,42,43,44,46,48,49,50,51,52,53,54,55,56,57,59,60,61,62,63,64,65,66,67,68,69,70,71,72,73,74,75,76,77,78,79,80,81,82,83,84
    ],
    [
      29,30,31,32,33,34,35,39,41,42,43,44,46,48,49,50,51,52,53,54,55,56,57,59,60,61,62,63,64,65,66,67,68,69,70,71,72,73,74,75,76,77,78,79,80,81,82,83,84
    ],
    [
      29,30,31,32,33,34,35,39,41,42,43,44,46,48,49,50,51,52,53,54,55,56,57,59,60,61,62,63,64,65,66,67,68,69,70,71,72,73,74,75,76,77,78,79,80,81,82,83,84
    ],
    [
      29,30,31,32,33,34,35,39,41,42,43,44,46,48,49,50,51,52,53,54,55,56,57,59,60,61,62,63,64,65,66,67,68,69,70,71,72,73,74,75,76,77,78,79,80,81,82,83,84
    ],
    [
      17,19,22,23,27,38,47,58
    ],
    [
      29,30,31,32,33,34,35,39,41,42,43,44,46,48,49,50,51,52,53,54,55,56,57,59,60,61,62,63,64,65,66,67,68,69,70,71,72,73,74,75,76,77,78,79,80,81,82,83,84
    ],
    [
      29,30,31,32,33,34,35,39,41,42,43,44,46,48,49,50,51,52,53,54,55,56,57,59,60,61,62,63,64,65,66,67,68,69,70,71,72,73,74,75,76,77,78,79,80,81,82,83,84
    ],
    [
      29,30,31,32,33,34,35,39,41,42,43,44,46,48,49,50,51,52,53,54,55,56,57,59,60,61,62,63,64,65,66,67,68,69,70,71,72,73,74,75,76,77,78,79,80,81,82,83,84
    ],
    [
      29,30,31,32,33,34,35,39,41,42,43,44,46,48,49,50,51,52,53,54,55,56,57,59,60,61,62,63,64,65,66,67,68,69,70,71,72,73,74,75,76,77,78,79,80,81,82,83,84
    ],
    [
      29,30,31,32,33,34,35,39,41,42,43,44,46,48,49,50,51,52,53,54,55,56,57,59,60,61,62,63,64,65,66,67,68,69,70,71,72,73,74,75,76,77,78,79,80,81,82,83,84
    ],
    [
      29,30,31,32,33,34,35,39,41,42,43,44,46,48,49,50,51,52,53,54,55,56,57,59,60,61,62,63,64,65,66,67,68,69,70,71,72,73,74,75,76,77,78,79,80,81,82,83,84
    ],
    [
      29,30,31,32,33,34,35,39,41,42,43,44,46,48,49,50,51,52,53,54,55,56,57,59,60,61,62,63,64,65,66,67,68,69,70,71,72,73,74,75,76,77,78,79,80,81,82,83,84
    ],
    [
      29,30,31,32,33,34,35,39,41,42,43,44,46,48,49,50,51,52,53,54,55,56,57,59,60,61,62,63,64,65,66,67,68,69,70,71,72,73,74,75,76,77,78,79,80,81,82,83,84
    ],
    [
      29,30,31,32,33,34,35,39,41,42,43,44,46,48,49,50,51,52,53,54,55,56,57,59,60,61,62,63,64,65,66,67,68,69,70,71,72,73,74,75,76,77,78,79,80,81,82,83,84
    ],
    [
      29,30,31,32,33,34,35,39,41,42,43,44,46,48,49,50,51,52,53,54,55,56,57,59,60,61,62,63,64,65,66,67,68,69,70,71,72,73,74,75,76,77,78,79,80,81,82,83,84
    ],
    [
      29,30,31,32,33,34,35,39,41,42,43,44,46,48,49,50,51,52,53,54,55,56,57,59,60,61,62,63,64,65,66,67,68,69,70,71,72,73,74,75,76,77,78,79,80,81,82,83,84
    ],
    [
      29,30,31,32,33,34,35,39,41,42,43,44,46,48,49,50,51,52,53,54,55,56,57,59,60,61,62,63,64,65,66,67,68,69,70,71,72,73,74,75,76,77,78,79,80,81,82,83,84
    ],
    [
      29,30,31,32,33,34,35,39,41,42,43,44,46,48,49,50,51,52,53,54,55,56,57,59,60,61,62,63,64,65,66,67,68,69,70,71,72,73,74,75,76,77,78,79,80,81,82,83,84
    ],
    [
      29,30,31,32,33,34,35,39,41,42,43,44,46,48,49,50,51,52,53,54,55,56,57,59,60,61,62,63,64,65,66,67,68,69,70,71,72,73,74,75,76,77,78,79,80,81,82,83,84
    ],
    [
      29,30,31,32,33,34,35,39,41,42,43,44,46,48,49,50,51,52,53,54,55,56,57,59,60,61,62,63,64,65,66,67,68,69,70,71,72,73,74,75,76,77,78,79,80,81,82,83,84
    ],
    [
      29,30,31,32,33,34,35,39,41,42,43,44,46,48,49,50,51,52,53,54,55,56,57,59,60,61,62,63,64,65,66,67,68,69,70,71,72,73,74,75,76,77,78,79,80,81,82,83,84
    ],
    [
      29,30,31,32,33,34,35,39,41,42,43,44,46,48,49,50,51,52,53,54,55,56,57,59,60,61,62,63,64,65,66,67,68,69,70,71,72,73,74,75,76,77,78,79,80,81,82,83,84
    ],
    [
      29,30,31,32,33,34,35,39,41,42,43,44,46,48,49,50,51,52,53,54,55,56,57,59,60,61,62,63,64,65,66,67,68,69,70,71,72,73,74,75,76,77,78,79,80,81,82,83,84
    ],
    [
      29,30,31,32,33,34,35,39,41,42,43,44,46,48,49,50,51,52,53,54,55,56,57,59,60,61,62,63,64,65,66,67,68,69,70,71,72,73,74,75,76,77,78,79,80,81,82,83,84
    ],
    [
      29,30,31,32,33,34,35,39,41,42,43,44,46,48,49,50,51,52,53,54,55,56,57,59,60,61,62,63,64,65,66,67,68,69,70,71,72,73,74,75,76,77,78,79,80,81,82,83,84
    ],
    [
      29,30,31,32,33,34,35,39,41,42,43,44,46,48,49,50,51,52,53,54,55,56,57,59,60,61,62,63,64,65,66,67,68,69,70,71,72,73,74,75,76,77,78,79,80,81,82,83,84
    ],
    [
      29,30,31,32,33,34,35,39,41,42,43,44,46,48,49,50,51,52,53,54,55,56,57,59,60,61,62,63,64,65,66,67,68,69,70,71,72,73,74,75,76,77,78,79,80,81,82,83,84
    ],
    [
      29,30,31,32,33,34,35,39,41,42,43,44,46,48,49,50,51,52,53,54,55,56,57,59,60,61,62,63,64,65,66,67,68,69,70,71,72,73,74,75,76,77,78,79,80,81,82,83,84
    ],
    [
      29,30,31,32,33,34,35,39,41,42,43,44,46,48,49,50,51,52,53,54,55,56,57,59,60,61,62,63,64,65,66,67,68,69,70,71,72,73,74,75,76,77,78,79,80,81,82,83,84
    ],
    [
      29,30,31,32,33,34,35,39,41,42,43,44,46,48,49,50,51,52,53,54,55,56,57,59,60,61,62,63,64,65,66,67,68,69,70,71,72,73,74,75,76,77,78,79,80,81,82,83,84
    ],
    [
      29,30,31,32,33,34,35,39,41,42,43,44,46,48,49,50,51,52,53,54,55,56,57,59,60,61,62,63,64,65,66,67,68,69,70,71,72,73,74,75,76,77,78,79,80,81,82,83,84
    ]
  ]
}